##############
#....#.......#
#....#.......#
#....#.......#
#....#.......#
#....#.......#
#....#.......#
#....#.......#
#....#.......#
#....#.......#
#....#.......#
#....#.......#
#............#
############## 